1000220001
1002332001
1012442101
1002332001
1000220001