3322442233
2244004422
1122442211
1111111111
1233443321
2300000032
3000000003