4444444444
4444334444
4433333344
3333223333
3322222233
2222112222
2211111122
1111111111