1122332211
2233443322
3322002233
3322002233
2233443322